11111111111111
1C11000P000011
10C00111110011
100111E0000011
11111111111111
