11111111111111111111111111
1E00000000000C000000000001
10100101101101000000010101
10100100101001000000010101
1P0000000C00000000000000C1
11111111111111111111111111
