NO ./textures/Wall_x512_vertical.xpm
SO ./textures/Wall_x512_vertical.xpm
WE ./textures/Wall_x512_vertical_side.xpm
EA ./textures/Wall_x512_vertical_side.xpm
F 10,115,150
C 200,255,255

        1111111111111111111111111
        1000000000110000000000001
        1011000001110000001000001
        1001000000000000000000001
111111111011000001110000000000001
100000000011000001110001111111111
11110111111111011100000000001
11110111111111011101010000001
11000000110101011100000000001
10000000000000110101001000001
10000000000000001100000010001
10000000000000011010100100001
1000E000000000001100000010001
10000000000000001101010010001
1000000000000000110101001000111111111111111111
1100000111010101111101111000111111111111111111
11110111 1110101 101111010001
11111111 1111111 111111111111
